xxxxxxxxxxxxxxxxxxxxxxxxxxxxxxxxxxxxxxxxxxxxxxxxxxxxxxxxxxxxxxx
x                              xx                             x
x        xxxxxx                xx               xxxxxx        x
x                                                             x
x                 xxxx                   xxxx                 x
x                 x                         x                 x
x                                                             x
x       xxx                                         xxx       x
x         x                                         x         x
x         x                                         x         x
x         x   xx                               xx   x         x
x         x   xx                               xx   x         x
x         x                                         x         x
x       xxx                                         xxx       x
x                                                             x
x                 x                         x                 x
x                 xxxx                   xxxx                 x
x                                                             x
x        xxxxxx                xx               xxxxxx        x
x                              xx                             x
xxxxxxxxxxxxxxxxxxxxxxxxxxxxxxxxxxxxxxxxxxxxxxxxxxxxxxxxxxxxxxx
